1111111111111111111111111111111111111111
10000000000P000000000C100000000000111111
1000000000000111111111101111111110100001
10011111000100000000000000010000000011C1
10010C01100C0000011111111111011111111111
100101001110000111E1111000010000C0000001
100101000C100001010000101101111111111011
1000010000100001110110000100000000000011
1111111111111111111111111111111111111111