1111111111
1E0010C001
10C0C01001
110E01PCE1
1111111111
