1111111111
1E0010C001
10C0C01001
110001P001
1111111111